#########################################
#   # # # # # # # # # # # # # # # # # # #
# # # # # # # # # # # # # # # # # # # # #
# # # # # # # # # # # # # # # # # # # # #
# # # # # # # # # # # # # # # # # # # # #
# #   # # # # # # # # # # # # # # # # # #
# # # # # # # # # # # # # # # # # # # # #
# # #                                   #
####################################### #
# # # #                                 #
#########################################